111111111111111111111111111111
1E0000000000000C00000C00000001
101001010010000010100100001101
101001001010101000100100000101
1P0000000C00C000000000000000C1
1C0000000000C000000000000000C1
100000000100C000000000000000C1
110000000C00C000000000000000C1
100000000100C000000000000000C1
110000000C00C000000000000000C1
111111111111111111111111111111